lvl_type,ID,vision_limit,vision_bound,vision_limit_aware,search_depth,kb_search_depth,kb_update_delay,lvl_str
Mid-2-120,7,TRUE,120,TRUE,5,3,1,"XXXOXMXXXPXXDXX 
XX           XX 
XX 2         XX 
XX        1  XX 
XX   XBWXX   XX 
XX   XXXSX   XX 
XX           XX 
XX           XX 
XX           XX 
XXXXXXXXXXXXXXX
XXXXXXXXXXXXXXX"
Side-3-120,5,TRUE,120,TRUE,5,3,1,"XXXXXXXXXXXXXXX 
XXXXBXPXDXMXXXX 
XXX        OXXX 
XXW 2      XXXX 
XXX       1XXXX 
XXXXXXX    XXXX 
XXXXSXX    XXXX 
XXX        XXXX 
XXXXXXXXXXXXXXX 
XXXXXXXXXXXXXXX "
Mid-1-120,6,TRUE,120,TRUE,5,3,1,"XXXDXWXPXXXXXXX 
XX           MX 
XX 2         OX 
XX        1  XX 
XX   XBXXX   XX 
XX   XXXSX   XX 
XX           XX 
XX           XX 
XXXXXXXXXXXXXXX 
XXXXXXXXXXXXXXX "
None-3-120,2,TRUE,120,TRUE,5,3,1,"XXXXXXXXXXXXXXX 
XXXXBXXPXDXXXXX 
XXX        SXXX 
XXW  2     XXXX 
XXX        XXXX 
XXM      1 XXXX 
XXO        XXXX 
XXX        XXXX 
XXXXXXXXXXXXXXX 
XXXXXXXXXXXXXXX "
Mid-1_120_not_aware,6,TRUE,120,FALSE,5,3,1,"XXXDXWXPXXXXXXX 
XX           MX 
XX 2         OX 
XX        1  XX 
XX   XBXXX   XX 
XX   XXXSX   XX 
XX           XX 
XX           XX 
XXXXXXXXXXXXXXX 
XXXXXXXXXXXXXXX "
None-3_120_not_aware,2,TRUE,120,FALSE,5,3,1,"XXXXXXXXXXXXXXX 
XXXXBXXPXDXXXXX 
XXX        SXXX 
XXW  2     XXXX 
XXX        XXXX 
XXM      1 XXXX 
XXO        XXXX 
XXX        XXXX 
XXXXXXXXXXXXXXX 
XXXXXXXXXXXXXXX "
Side-3_120_not_aware,5,TRUE,120,FALSE,5,3,1,"XXXXXXXXXXXXXXX 
XXXXBXPXDXMXXXX 
XXX        OXXX 
XXW 2      XXXX 
XXX       1XXXX 
XXXXXXX    XXXX 
XXXXSXX    XXXX 
XXX        XXXX 
XXXXXXXXXXXXXXX 
XXXXXXXXXXXXXXX "
Mid-2_120_not_aware,7,TRUE,120,FALSE,5,3,1,"XXXOXMXXXPXXDXX 
XX           XX 
XX 2         XX 
XX        1  XX 
XX   XBWXX   XX 
XX   XXXSX   XX 
XX           XX 
XX           XX 
XX           XX 
XXXXXXXXXXXXXXX
XXXXXXXXXXXXXXX"
