lvl_type,ID,vision_limit,vision_bound,vision_limit_aware,search_depth,kb_search_depth,kb_update_delay,lvl_str
None-1-120,0,TRUE,120,TRUE,5,0,1,"XXXXXXXXXXXXXXX 
XXXMXBXPXDXXXXX 
XXO        XXXX 
XXX   2    WXXX 
XXX        XXXX 
XXX      1 XXXX 
XXS        XXXX 
XXX        XXXX 
XXXXXXXXXXXXXXX 
XXXXXXXXXXXXXXX "
None-1_120_not_aware,0,TRUE,120,FALSE,5,0,1,"XXXXXXXXXXXXXXX 
XXXMXBXPXDXXXXX 
XXO        XXXX 
XXX   2    WXXX 
XXX        XXXX 
XXX      1 XXXX 
XXS        XXXX 
XXX        XXXX 
XXXXXXXXXXXXXXX 
XXXXXXXXXXXXXXX "
Side-3-120,5,TRUE,120,TRUE,5,0,1,"XXXXXXXXXXXXXXX 
XXXXBXPXDXMXXXX 
XXX        OXXX 
XXW 2      XXXX 
XXX       1XXXX 
XXXXXXX    XXXX 
XXXXSXX    XXXX 
XXX        XXXX 
XXXXXXXXXXXXXXX 
XXXXXXXXXXXXXXX "
Side-3_120_not_aware,5,TRUE,120,FALSE,5,0,1,"XXXXXXXXXXXXXXX 
XXXXBXPXDXMXXXX 
XXX        OXXX 
XXW 2      XXXX 
XXX       1XXXX 
XXXXXXX    XXXX 
XXXXSXX    XXXX 
XXX        XXXX 
XXXXXXXXXXXXXXX 
XXXXXXXXXXXXXXX "
Mid-2-120,7,TRUE,120,TRUE,5,0,1,"XXXOXMXXXPXXDXX 
XX           XX 
XX 2         XX 
XX        1  XX 
XX   XBWXX   XX 
XX   XXXSX   XX 
XX           XX 
XX           XX 
XX           XX 
XXXXXXXXXXXXXXX
XXXXXXXXXXXXXXX"
Mid-2_120_not_aware,7,TRUE,120,FALSE,5,0,1,"XXXOXMXXXPXXDXX 
XX           XX 
XX 2         XX 
XX        1  XX 
XX   XBWXX   XX 
XX   XXXSX   XX 
XX           XX 
XX           XX 
XX           XX 
XXXXXXXXXXXXXXX
XXXXXXXXXXXXXXX"
Side-2_120_not_aware,4,TRUE,120,FALSE,5,0,1,"XXXXXXXXXXXXXXX 
XXXXMOXXPXDXXXX 
XXX        XXXX 
XXX   2    WXXX 
XXX        XXXX 
XXX      1 BXXX
XXX        XXXX 
XXXXXXXX   XXXX 
XXXXXXXS   XXXX 
XXXXXXXXXXXXXXX 
XXXXXXXXXXXXXXX "
Side-2-120,4,TRUE,120,TRUE,5,0,1,"XXXXXXXXXXXXXXX 
XXXXMOXXPXDXXXX 
XXX        XXXX 
XXX   2    WXXX 
XXX        XXXX 
XXX      1 BXXX
XXX        XXXX 
XXXXXXXX   XXXX 
XXXXXXXS   XXXX 
XXXXXXXXXXXXXXX 
XXXXXXXXXXXXXXX "
None-2-120,1,TRUE,120,TRUE,5,0,1,"XXXXXXXXXXXXXXX 
XXXXDXWXBXPXXXX 
XXX        XXXX 
XXX  2     MXXX 
XXX        OXXX 
XXX     1  XXXX 
XXX        XXXX 
XXX        SXXX 
XXXXXXXXXXXXXXX 
XXXXXXXXXXXXXXX "
None-2_120_not_aware,1,TRUE,120,FALSE,5,0,1,"XXXXXXXXXXXXXXX 
XXXXDXWXBXPXXXX 
XXX        XXXX 
XXX  2     MXXX 
XXX        OXXX 
XXX     1  XXXX 
XXX        XXXX 
XXX        SXXX 
XXXXXXXXXXXXXXX 
XXXXXXXXXXXXXXX "
Mid-1_120_not_aware,6,TRUE,120,FALSE,5,0,1,"XXXDXWXPXXXXXXX 
XX           MX 
XX 2         OX 
XX        1  XX 
XX   XBXXX   XX 
XX   XXXSX   XX 
XX           XX 
XX           XX 
XXXXXXXXXXXXXXX 
XXXXXXXXXXXXXXX "
Mid-1-120,6,TRUE,120,TRUE,5,0,1,"XXXDXWXPXXXXXXX 
XX           MX 
XX 2         OX 
XX        1  XX 
XX   XBXXX   XX 
XX   XXXSX   XX 
XX           XX 
XX           XX 
XXXXXXXXXXXXXXX 
XXXXXXXXXXXXXXX "
Side-1-120,3,TRUE,120,TRUE,5,0,1,"XXXXXXXXXXXXXXX 
XXXXXXXXPXXXXXX 
XXX        XXXX 
XXW   2    BXXX 
XXX        XXXX 
XXD        XSXX 
XXX        1 XX 
XXO          XX 
XXXMXXXXXXXXXXX 
XXXXXXXXXXXXXXX "
Side-1_120_not_aware,3,TRUE,120,FALSE,5,0,1,"XXXXXXXXXXXXXXX 
XXXXXXXXPXXXXXX 
XXX        XXXX 
XXW   2    BXXX 
XXX        XXXX 
XXD        XSXX 
XXX        1 XX 
XXO          XX 
XXXMXXXXXXXXXXX 
XXXXXXXXXXXXXXX "
Mid-3_120_not_aware,8,TRUE,120,FALSE,5,0,1,"XXXOMXXXXPXXXXX 
XX           XX 
XB    2      XX 
XX         1 XX 
XD   XXWXX   XX 
XX   XSXXX   XX 
XX           XX 
XX           XX 
XXXXXXXXXXXXXXX
XXXXXXXXXXXXXXX "
Mid-3-120,8,TRUE,120,TRUE,5,0,1,"XXXOMXXXXPXXXXX 
XX           XX 
XB    2      XX 
XX         1 XX 
XD   XXWXX   XX 
XX   XSXXX   XX 
XX           XX 
XX           XX 
XXXXXXXXXXXXXXX
XXXXXXXXXXXXXXX "
None-3_120_not_aware,2,TRUE,120,FALSE,5,0,1,"XXXXXXXXXXXXXXX 
XXXXBXXPXDXXXXX 
XXX        SXXX 
XXW  2     XXXX 
XXX        XXXX 
XXM      1 XXXX 
XXO        XXXX 
XXX        XXXX 
XXXXXXXXXXXXXXX 
XXXXXXXXXXXXXXX "
None-3-120,2,TRUE,120,TRUE,5,0,1,"XXXXXXXXXXXXXXX 
XXXXBXXPXDXXXXX 
XXX        SXXX 
XXW  2     XXXX 
XXX        XXXX 
XXM      1 XXXX 
XXO        XXXX 
XXX        XXXX 
XXXXXXXXXXXXXXX 
XXXXXXXXXXXXXXX "
