lvl_type,ID,agent_unstuck,human_unstuck,vision_limit,vision_bound,vision_limit_aware,search_depth,kb_search_depth,kb_update_delay,lvl_str
steak_stations,0,TRUE,TRUE,FALSE,0,TRUE,5,3,1,"XXXXXXXXXXXXXXX
XXBXXXXMXXXXXXX
XX           XX 
XO           XX
XX   XXPXX   XX
XX   XXXXX   XX
XX    2 1    DX
XS           XX
XXXXXXXXXXWXXXX 
XXXXXXXXXXXXXXX"
steak_stations3,2,TRUE,TRUE,TRUE,120,TRUE,5,3,1,"XXXXXXXXXXXXXXX
XXXPXXOXXXXXDXX
XX           XX
XM           XX
XX  XXBXXWX  XX
XX  XXXXXXX  XX
XX        2  XX
XS    1      XX
XXXXXXXXXXXXXXX
XXXXXXXXXXXXXXX"
Side-2_120_not_aware,1,TRUE,TRUE,FALSE,0,TRUE,5,3,1,"XXXXXXXXXXXXXXX 
XXXXMOXXPXDXXXX 
XXX        XXXX 
XXX   2    WXXX 
XXX        XXXX 
XXX      1 BXXX
XXX        XXXX 
XXXXXXXX   XXXX 
XXXXXXXS   XXXX 
XXXXXXXXXXXXXXX 
XXXXXXXXXXXXXXX "
None-2-120,1,TRUE,TRUE,TRUE,120,TRUE,5,3,1,"XXXXXXXXXXXXXXX 
XXXXDXWXBXPXXXX 
XXX        XXXX 
XXX  2     MXXX 
XXX        OXXX 
XXX     1  XXXX 
XXX        XXXX 
XXX        SXXX 
XXXXXXXXXXXXXXX 
XXXXXXXXXXXXXXX "
Side-1-120,1,TRUE,TRUE,TRUE,120,TRUE,5,3,1,"XXXXXXXXXXXXXXX 
XXXXXXXXPXXXXXX 
XXX        XXXX 
XXW   2    BXXX 
XXX        XXXX 
XXD        XSXX 
XXX        1 XX 
XXO          XX 
XXXMXXXXXXXXXXX 
XXXXXXXXXXXXXXX "
